{
	"Name" : "Test",
	"Size" : { "x" : 12, "y" : 12},
	"Tile" : "data/tiles/base_out_atlas.bmp",
	"Floorx" : 	[ 	1, 1, 1, 1, 1, 1, 1, 1, 1, 1, 1, 1, 
					1, 0, 0, 0, 0, 0, 0, 0, 0, 0, 0, 1, 
					1, 0, 0, 0, 0, 0, 0, 0, 0, 0, 0, 1, 
					1, 0, 0, 0, 0, 0, 0, 0, 0, 0, 0, 1, 
					1, 0, 0, 0, 0, 0, 0, 0, 0, 0, 0, 1, 
					1, 0, 0, 0, 0, 0, 0, 0, 0, 0, 0, 1, 
					1, 0, 0, 0, 0, 0, 0, 0, 0, 0, 0, 1, 
					1, 0, 0, 0, 0, 0, 0, 0, 0, 0, 0, 1, 
					1, 0, 0, 0, 0, 0, 0, 0, 0, 0, 0, 1, 
					1, 0, 0, 0, 0, 0, 0, 0, 0, 0, 0, 1, 
					1, 0, 0, 0, 0, 0, 0, 0, 0, 0, 0, 1, 
					1, 1, 1, 1, 1, 1, 1, 1, 1, 1, 1, 1
				],
    "Floory" : 	[ 	1, 1, 1, 1, 1, 1, 1, 1, 1, 1, 1, 1, 
					1, 0, 0, 0, 0, 0, 0, 0, 0, 0, 0, 1, 
					1, 0, 0, 0, 0, 0, 0, 0, 0, 0, 0, 1, 
					1, 0, 0, 0, 0, 0, 0, 0, 0, 0, 0, 1, 
					1, 0, 0, 0, 0, 0, 0, 0, 0, 0, 0, 1, 
					1, 0, 0, 0, 0, 0, 0, 0, 0, 0, 0, 1, 
					1, 0, 0, 0, 0, 0, 0, 0, 0, 0, 0, 1, 
					1, 0, 0, 0, 0, 0, 0, 0, 0, 0, 0, 1, 
					1, 0, 0, 0, 0, 0, 0, 0, 0, 0, 0, 1, 
					1, 0, 0, 0, 0, 0, 0, 0, 0, 0, 0, 1, 
					1, 0, 0, 0, 0, 0, 0, 0, 0, 0, 0, 1, 
					1, 1, 1, 1, 1, 1, 1, 1, 1, 1, 1, 1
				],
	"Floors" : 	[ 	1, 1, 1, 1, 1, 1, 1, 1, 1, 1, 1, 1, 
					1, 0, 0, 0, 0, 0, 0, 0, 0, 0, 0, 1, 
					1, 0, 0, 0, 0, 0, 0, 0, 0, 0, 0, 1, 
					1, 0, 0, 0, 0, 0, 0, 0, 0, 0, 0, 1, 
					1, 0, 0, 0, 0, 0, 0, 0, 0, 0, 0, 1, 
					1, 0, 0, 0, 0, 0, 0, 0, 0, 0, 0, 1, 
					1, 0, 0, 0, 0, 0, 0, 0, 0, 0, 0, 1, 
					1, 0, 0, 0, 0, 0, 0, 0, 0, 0, 0, 1, 
					1, 0, 0, 0, 0, 0, 0, 0, 0, 0, 0, 1, 
					1, 0, 0, 0, 0, 0, 0, 0, 0, 0, 0, 1, 
					1, 0, 0, 0, 0, 0, 0, 0, 0, 0, 0, 1, 
					1, 1, 1, 1, 1, 1, 1, 1, 1, 1, 1, 1],
	"Blocks" : ["1", "＃"],
	"Objects" : [{
					"Name" 	: 	"David",
					"Type" 	: 	1,
					"canStep" : 0,
					"x"		:	4,
					"y"		:	4,
					"Tile"  :   "data/tiles/obj_misk_atlas.bmp",
					"Icon"	:   { "x" : 1, "y" : 1 },
					"Trigger" : "DavidTrigger",
					"trigType" : 1
				},{
					"Name" 	: 	"Trap",
					"Type" 	: 	1,
					"canStep" : 1,
					"x"		:	8,
					"y"		:	4,
					"Tile"  :   "data/tiles/obj_misk_atlas.bmp",
					"Icon"	:	{ "x" : 2, "y" : 2 },
					"Trigger" : "TrapTrigger",
					"trigType" : 2

				},{
					"Name" 	: 	"test2",
					"Type" 	: 	1,
					"canStep" : 1,
					"x"		:	11,
					"y"		:	3,
					"Tile"  :   "data/tiles/obj_misk_atlas.bmp",
					"Icon"	:	{ "x" : 1, "y" : 2 },
					"Trigger" : "test_test2Trigger",
					"trigType" : 2
				}]
}
